JwUyJoGNtWlj | JwotyUNGJlWj
IuPocSZsuEGP | PucGEZsSPoIu
ATyjJVVoev xKsdCe | JxsKVeAeo dVjTvyC
zJOenWyWF mQphIrKjqgexGfOxdjvfokPIPRw | PIQoGRKxxFOpmfr dzejvIqOfPWhgeyjwWJkn
alFqmlPXlKFoxjXcJxYuVwdYIaYWxsTMyD | YxjXXlFyPTxWlYFwqxDMasVmYolKducIaJ
hAePHBXiiKPxrmTmdsYAdkYOlMqthNmNSslZ | NYHqOmlkYiPrNmStTPsddiXxhZhMlsKmBAeA
IPwCNK | PwCINK
kYWszKFxdLxxMjVkpBjLsoZS BKoFaUn  | dMLaSxFxK  zFoxjBjYZLBWsksVoUkKpn
KwEZmKgNymUthbGLyEaOXRoHLGwXFN | mOKbwEGHNwFXtRyUNKXhoyGZmLLaEg
hELLO cODEEVAL | Hello Codeeval
Heelo Codevval | Hello Codeeval
LbMNGeVSXBa | VXGbeBMaSNL
GEXkwKfzCXrPqMkystnLdxqXOPyrJbTcyIDwpNPf | xPynycrdPJrbPDkpfwCLXqOXkIqNtfzywXMKGsET
fEzKOZCTgubOl | EObufKlgZOTzC
uyHhtfqKQVD | VyDtHqhQfuK
OddjhyPjBiCVJ | OBCdhjJyijdVP
FnGxHUSQJOondtiFHgVhiHdBlMPayiuZmT bmiS | GFSimnZiHFVQuUOtTngybHPMiJSddihx lHaoBm
v PW HEHiYfVVikWtwZWff IHqJfI | kfViwHEfI YWIPJft ZHHWvf ViqW
KMfkjFopeUToGDQtTcDub   | pDjDFfbUTQtoGKe okcuMT 
jvBrmlZueaQiHwNQJeTzdhFFGPPZolpQtxBuS | ilFvPFBQBxSjuTlPJZradZoeQQzhpumeHNtwG
BvCQHISEINFS | vBEISQINCSFH
Hello Codeeval | Hello Codeeval
pCEIae qMJGtsUSGsSWm | mSsJGMsetaE CGIWpSqU
msGmReQyvUEGTd | RQmvTyemEUGsdG
q YfGMnemIbNJdn |  MbdGnJnINYfqem
fQjDtZImxkwnto | jQmtIZnoxfkDwt
smRJNcHcQWfPFgtfIPqqmzXk | cPzmsqcmqJfXPkfgQIRWHNFt
ZgbVhOaUWSXe | VSOUeZaXgWbh
OU vSSAhFaVrFURRfH lcVsVk XDNzy | RyhRHlkUsVXzAUa  FSfSVvVr OFNDc
rSPliKEjrIYfUxuKlHFIYvr | vIEUriPFrlYrSYfujHKIlxK
nkXHclFEpqk | HpFEkXnlkqc
XnKCBkiMAAvGRuQeqc FS | kqBvXGKcCAFRQMiunASe 
xSDvKmsGi cFxYPnWAgNH | SxDsFHYKmniWPNgxAG vc
lSWdFZUDLjpRcag VKRwDJUrbrPirIxNQsjNd | pcRDwirUlKaIFUbPjWrZJxQNRNjgs DVSddrL
MIobpecnmAMFjp | MpmpnAcFjoebMI
SwlTz | TlSwz
zJBNmt NWyMNiiXCcTodUFVQJNsIkxxQ | JNIiMTVziyBQxQmNXkxNJtCoNscFWdU 
mGEuISqooIjvqJLmCknYPQFv | vnmLoGEJIFCuqmqjokIQvPYS
xvZWZtEURqdh | EZtZhqUdWRxv
TKrXEOnYPrlfYsuqEPzJppkn | rnuErKPYnlOfpqpXkJTYzPEs
